5 13 31
###############################
#p*5   b* *  1 2*   *  *2* *  #
# #*# #s# # #*#*# # # #*#*#*# #
#* *2 *  4  * *s *   f** 4* * #
# #*# # # #*# # #*#*# # #*# #*#
#     4  x* **  *f *     b    #
# # # # # #*# # # #*# # # # # #
#*1 s      *  *   1  *        #
# # # # #*# # # #*#*# #b# # # #
#*    **  *1  4   *     *     #
# #*# # # # # # #*# # # # #f# #
#      5    *   *2 *    *     #
###############################