4 13 31
###############################
#p    b* *  1 2*   *  *2* *   #
# #*# #s# # #*#*# # # #*#*#*# #
# * 2 *  4  ***  *    *  4* * #
# #*# # # #*# # #*#*# # # # #*#
#     4   *x **  *f *         #
# # # # # #*# # # #*# #*# # # #
#*1 s      *  *   1  *        #
# # # # #*# # # #*#*# #b# # # #
#*    **  *1  4   *           #
# #*# # # # # # #*# # # # #f# #
#           *   *2 *          #
###############################